NO ./textures/north.png
SO ./textures/south.png
WE ./textures/west.png
EA ./textures/east.png
F 120,200,0
F 100,150,50
C 225,30,0
        1111111111111111111111111
        1000000000110000000000001
        10110000011100000N0000001
        1111111111111111111111111
